1111111111111111111
1111111110111111111
1110000000000000011
1110000002011111011
1110000000011111011
1110000000011111011
1112000000011111211
1110000000011111011
1110000000011111011
11100000C0011111011
1110111110011111011
1110111110011111011
111011111P011111011
1110111110011111011
1110111110000000011
1110111110011111011
1110111110E11111011
1111111111111111111
