00011111111111111100
00011111111111111100
11011111111111111111
11100000000000000111
11101111100111110111
11101111120111110111
11101111100111110111
111011111C0111110111
11101111100111110111
11101111100111110111
1110111110C111110111
1110111110C111110111
1110111110C111110111
11101111100111110111
11101111103111110111
11101111100111110111
11101111100111110111
11101111100111110111
11101111100111110111
